#######################################
# Syntax Coloring Map For WiFiProvisioner
#######################################

WiFiProvisioner	KEYWORD2
AP_NAME	KEYWORD2
HTML_TITLE	KEYWORD2
THEME_COLOR	KEYWORD2
SVG_LOGO	KEYWORD2
PROJECT_TITLE	KEYWORD2
PROJECT_INFO	KEYWORD2
INPUT_TEXT	KEYWORD2
INPUT_PLACEHOLDER	KEYWORD2
INPUT_LENGTH	KEYWORD2
FOOTER_INFO	KEYWORD2
INPUT_INVALID_LENGTH	KEYWORD2
INPUT_NOT_VALID	KEYWORD2
CONNECTION_SUCCESSFUL	KEYWORD2
RESET_CONFIRMATION_TEXT	KEYWORD2

connectToWiFi	KEYWORD1
setupAccessPointAndServer	KEYWORD1
resetCredentials	KEYWORD1
setInputCheckCallback	KEYWORD1
setFactoryResetCallback	KEYWORD1
setOnProvisionCallback	KEYWORD1
setConnectionTimeout	KEYWORD1
setRestartOnSuccess	KEYWORD1
setShowInputField	KEYWORD1
enableSerialDebug	KEYWORD1
